40 30
1111111111111111111111111111111111111111
1111111111111111111111111100000000000001
1111111111111111111111111100000000000001
1111111111000000001000001100000000000001
1111111111000000001000001100000000000001
1111111111000000000000001100000000000001
1111111111000000000000001100000000000001
1111111111000000001000001100000000000001
1111111111000000001000001100000000000001
1111111111111100111100111100000000000001
1000000001000000000000000111100001111111
1000000001000000000000000100000000000111
1000000001000000000000000100000000000111
1000000001000000000000000000000000000111
1000000000000000000000000000000000000111
1000000000000000000000000000000000000111
1000000001000000000000000000000000000111
1000000001000000000000000100000000000111
1000000001000000000000000100000000000111
1000000001000000000000000111100001111111
1111111111111100111100111100000000000001
1111111111000000001000001100000000000001
1111111111000000001000001100000000000001
1111111111000000000000001100000000000001
1111111111000000000000001100000000000001
1111111111000000001000001100000000000001
1111111111000000001000001100000000000001
1111111111111111111111111100000000000001
1111111111111111111111111100000000000001
1111111111111111111111111111111111111111
1
models/dragon.ply

4
0    5.0 0.0  0.0    1.0 1.0 1.0   0.0 180.0 0.0
0   10.0 0.0  1.0    2.0 2.0 2.0   0.0 180.0 0.0
0   10.0 0.0 -1.0    2.0 2.0 2.0   0.0 180.0 0.0
0   14.0 0.0  0.0    4.0 4.0 4.0   0.0 180.0 0.0
